####################
##@....#K...#......#
####.####.#.#.##.#.#
#K#..####!..#..#.#.#
#....#...##.##.#.#K#
##.###.#....##.#.!.#
#..##...##.....###.#
##..#.#..#########.#
#.!##.##.#.###K.#..#
#.#...##....#.#.#.##
#....##!..#.....#.*#
####################