####################
##@....#....#......#
####.####.#.#.##.#.#
#.#..#.##.#.#..#.#.#
#...#.......##.#.#.#
##.#..####.###.#.#.#
#..##....#.....#.###
##..#.##.#######...#
#.!##..#.###....##.#
#.###.##....###..#.#
#.....#...#......#.#
####################